قال+Negative+Continuous+P1S	قالمييورم
قال+Negative+Continuous+P1P	قالمييورز
قال+Negative+Continuous+P3P	قالمييور
قال+Negative+Continuous+P3P	قالمييورلر
قال+Negative+Continuous+P2P	قالمييورسڭز
قال+Negative+Continuous+P2S	قالمييورسڭ
قال+Negative+Continuous+P3S	قالمييور
قال+Negative+Aorist+P3P	قالماز
قال+Negative+Aorist+P3P	قالمازلر
قال+Negative+Aorist+P2P	قالمازسڭز
قال+Negative+Aorist+P2S	قالمازسڭ
قال+Negative+Aorist+P3S	قالماز
قال+Negative+Aorist+P1P	قالمايز
قال+Negative+Aorist+P1S	قالمام
قال+Positive+Continuous+P1S	قالييورم
قال+Positive+Continuous+P1P	قالييورز
قال+Positive+Continuous+P3P	قالييور
قال+Positive+Continuous+P3P	قالييورلر
قال+Positive+Continuous+P2P	قالييورسڭز
قال+Positive+Continuous+P2S	قالييورسڭ
قال+Positive+Continuous+P3S	قالييور
قال+Positive+Aorist+P1S	قالرم
قال+Positive+Aorist+P1P	قالرز
قال+Positive+Aorist+P3P	قالر
قال+Positive+Aorist+P3P	قالرلر
قال+Positive+Aorist+P2P	قالرسڭز
قال+Positive+Aorist+P2S	قالرسڭ
قال+Positive+Aorist+P3S	قالر
قوش+Negative+Continuous+P1S	قوشمييورم
قوش+Negative+Continuous+P1P	قوشمييورز
قوش+Negative+Continuous+P3P	قوشمييور
قوش+Negative+Continuous+P3P	قوشمييورلر
قوش+Negative+Continuous+P2P	قوشمييورسڭز
قوش+Negative+Continuous+P2S	قوشمييورسڭ
قوش+Negative+Continuous+P3S	قوشمييور
قوش+Negative+Aorist+P3P	قوشماز
قوش+Negative+Aorist+P3P	قوشمازلر
قوش+Negative+Aorist+P2P	قوشمازسڭز
قوش+Negative+Aorist+P2S	قوشمازسڭ
قوش+Negative+Aorist+P3S	قوشماز
قوش+Negative+Aorist+P1P	قوشمايز
قوش+Negative+Aorist+P1S	قوشمام
قوش+Positive+Continuous+P1S	قوشويورم
قوش+Positive+Continuous+P1P	قوشويورز
قوش+Positive+Continuous+P3P	قوشويور
قوش+Positive+Continuous+P3P	قوشويورلر
قوش+Positive+Continuous+P2P	قوشويورسڭز
قوش+Positive+Continuous+P2S	قوشويورسڭ
قوش+Positive+Continuous+P3S	قوشويور
قوش+Positive+Aorist+P1S	قوشورم
قوش+Positive+Aorist+P1P	قوشورز
قوش+Positive+Aorist+P3P	قوشور
قوش+Positive+Aorist+P3P	قوشورلر
قوش+Positive+Aorist+P2P	قوشورسڭز
قوش+Positive+Aorist+P2S	قوشورسڭ
قوش+Positive+Aorist+P3S	قوشور
اوقو+Negative+Continuous+P1S	اوقومييورم
اوقو+Negative+Continuous+P1P	اوقومييورز
اوقو+Negative+Continuous+P3P	اوقومييور
اوقو+Negative+Continuous+P3P	اوقومييورلر
اوقو+Negative+Continuous+P2P	اوقومييورسڭز
اوقو+Negative+Continuous+P2S	اوقومييورسڭ
اوقو+Negative+Continuous+P3S	اوقومييور
اوقو+Negative+Aorist+P3P	اوقوماز
اوقو+Negative+Aorist+P3P	اوقومازلر
اوقو+Negative+Aorist+P2P	اوقومازسڭز
اوقو+Negative+Aorist+P2S	اوقومازسڭ
اوقو+Negative+Aorist+P3S	اوقوماز
اوقو+Negative+Aorist+P1P	اوقومايز
اوقو+Negative+Aorist+P1S	اوقومام
اوقو+Positive+Continuous+P1S	اوقوويورم
اوقو+Positive+Continuous+P1P	اوقوويورز
اوقو+Positive+Continuous+P3P	اوقوويور
اوقو+Positive+Continuous+P3P	اوقوويورلر
اوقو+Positive+Continuous+P2P	اوقوويورسڭز
اوقو+Positive+Continuous+P2S	اوقوويورسڭ
اوقو+Positive+Continuous+P3S	اوقوويور
اوقو+Positive+Aorist+P1S	اوقوورم
اوقو+Positive+Aorist+P1P	اوقوورز
اوقو+Positive+Aorist+P3P	اوقوور
اوقو+Positive+Aorist+P3P	اوقوورلر
اوقو+Positive+Aorist+P2P	اوقوورسڭز
اوقو+Positive+Aorist+P2S	اوقوورسڭ
اوقو+Positive+Aorist+P3S	اوقوور
اويو+Negative+Continuous+P1S	اويومييورم
اويو+Negative+Continuous+P1P	اويومييورز
اويو+Negative+Continuous+P3P	اويومييور
اويو+Negative+Continuous+P3P	اويومييورلر
اويو+Negative+Continuous+P2P	اويومييورسڭز
اويو+Negative+Continuous+P2S	اويومييورسڭ
اويو+Negative+Continuous+P3S	اويومييور
اويو+Negative+Aorist+P3P	اويوماز
اويو+Negative+Aorist+P3P	اويومازلر
اويو+Negative+Aorist+P2P	اويومازسڭز
اويو+Negative+Aorist+P2S	اويومازسڭ
اويو+Negative+Aorist+P3S	اويوماز
اويو+Negative+Aorist+P1P	اويومايز
اويو+Negative+Aorist+P1S	اويومام
اويو+Positive+Continuous+P1S	اويوويورم
اويو+Positive+Continuous+P1P	اويوويورز
اويو+Positive+Continuous+P3P	اويوويور
اويو+Positive+Continuous+P3P	اويوويورلر
اويو+Positive+Continuous+P2P	اويوويورسڭز
اويو+Positive+Continuous+P2S	اويوويورسڭ
اويو+Positive+Continuous+P3S	اويوويور
اويو+Positive+Aorist+P1S	اويوورم
اويو+Positive+Aorist+P1P	اويوورز
اويو+Positive+Aorist+P3P	اويوور
اويو+Positive+Aorist+P3P	اويوورلر
اويو+Positive+Aorist+P2P	اويوورسڭز
اويو+Positive+Aorist+P2S	اويوورسڭ
اويو+Positive+Aorist+P3S	اويوور
آل+Negative+Continuous+P1S	آلمييورم
آل+Negative+Continuous+P1P	آلمييورز
آل+Negative+Continuous+P3P	آلمييور
آل+Negative+Continuous+P3P	آلمييورلر
آل+Negative+Continuous+P2P	آلمييورسڭز
آل+Negative+Continuous+P2S	آلمييورسڭ
آل+Negative+Continuous+P3S	آلمييور
آل+Negative+Aorist+P3P	آلماز
آل+Negative+Aorist+P3P	آلمازلر
آل+Negative+Aorist+P2P	آلمازسڭز
آل+Negative+Aorist+P2S	آلمازسڭ
آل+Negative+Aorist+P3S	آلماز
آل+Negative+Aorist+P1P	آلمايز
آل+Negative+Aorist+P1S	آلمام
آل+Positive+Continuous+P1S	آلييورم
آل+Positive+Continuous+P1P	آلييورز
آل+Positive+Continuous+P3P	آلييور
آل+Positive+Continuous+P3P	آلييورلر
آل+Positive+Continuous+P2P	آلييورسڭز
آل+Positive+Continuous+P2S	آلييورسڭ
آل+Positive+Continuous+P3S	آلييور
آل+Positive+Aorist+P1S	آلرم
آل+Positive+Aorist+P1P	آلرز
آل+Positive+Aorist+P3P	آلر
آل+Positive+Aorist+P3P	آلرلر
آل+Positive+Aorist+P2P	آلرسڭز
آل+Positive+Aorist+P2S	آلرسڭ
آل+Positive+Aorist+P3S	آلر
سو+Negative+Continuous+P1S	سومييورم
سو+Negative+Continuous+P1P	سومييورز
سو+Negative+Continuous+P3P	سومييور
سو+Negative+Continuous+P3P	سومييورلر
سو+Negative+Continuous+P2P	سومييورسڭز
سو+Negative+Continuous+P2S	سومييورسڭ
سو+Negative+Continuous+P3S	سومييور
سو+Negative+Aorist+P3P	سومز
سو+Negative+Aorist+P3P	سومزلر
سو+Negative+Aorist+P2P	سومزسڭز
سو+Negative+Aorist+P2S	سومزسڭ
سو+Negative+Aorist+P3S	سومز
سو+Negative+Aorist+P1P	سوميز
سو+Negative+Aorist+P1S	سومم
سو+Positive+Continuous+P1S	سوييورم
سو+Positive+Continuous+P1P	سوييورز
سو+Positive+Continuous+P3P	سوييور
سو+Positive+Continuous+P3P	سوييورلر
سو+Positive+Continuous+P2P	سوييورسڭز
سو+Positive+Continuous+P2S	سوييورسڭ
سو+Positive+Continuous+P3S	سوييور
سو+Positive+Aorist+P1S	سورم
سو+Positive+Aorist+P1P	سورز
سو+Positive+Aorist+P3P	سور
سو+Positive+Aorist+P3P	سورلر
سو+Positive+Aorist+P2P	سورسڭز
سو+Positive+Aorist+P2S	سورسڭ
سو+Positive+Aorist+P3S	سور
سور+Negative+Continuous+P1S	سورمييورم
سور+Negative+Continuous+P1P	سورمييورز
سور+Negative+Continuous+P3P	سورمييور
سور+Negative+Continuous+P3P	سورمييورلر
سور+Negative+Continuous+P2P	سورمييورسڭز
سور+Negative+Continuous+P2S	سورمييورسڭ
سور+Negative+Continuous+P3S	سورمييور
سور+Negative+Aorist+P3P	سورمز
سور+Negative+Aorist+P3P	سورمزلر
سور+Negative+Aorist+P2P	سورمزسڭز
سور+Negative+Aorist+P2S	سورمزسڭ
سور+Negative+Aorist+P3S	سورمز
سور+Negative+Aorist+P1P	سورميز
سور+Negative+Aorist+P1S	سورمم
سور+Positive+Continuous+P1S	سورويورم
سور+Positive+Continuous+P1P	سورويورز
سور+Positive+Continuous+P3P	سورويور
سور+Positive+Continuous+P3P	سورويورلر
سور+Positive+Continuous+P2P	سورويورسڭز
سور+Positive+Continuous+P2S	سورويورسڭ
سور+Positive+Continuous+P3S	سورويور
سور+Positive+Aorist+P1S	سورورم
سور+Positive+Aorist+P1P	سورورز
سور+Positive+Aorist+P3P	سورور
سور+Positive+Aorist+P3P	سورورلر
سور+Positive+Aorist+P2P	سورورسڭز
سور+Positive+Aorist+P2S	سورورسڭ
سور+Positive+Aorist+P3S	سورور
گور+Negative+Continuous+P1S	گورمييورم
گور+Negative+Continuous+P1P	گورمييورز
گور+Negative+Continuous+P3P	گورمييور
گور+Negative+Continuous+P3P	گورمييورلر
گور+Negative+Continuous+P2P	گورمييورسڭز
گور+Negative+Continuous+P2S	گورمييورسڭ
گور+Negative+Continuous+P3S	گورمييور
گور+Negative+Aorist+P3P	گورمز
گور+Negative+Aorist+P3P	گورمزلر
گور+Negative+Aorist+P2P	گورمزسڭز
گور+Negative+Aorist+P2S	گورمزسڭ
گور+Negative+Aorist+P3S	گورمز
گور+Negative+Aorist+P1P	گورميز
گور+Negative+Aorist+P1S	گورمم
گور+Positive+Continuous+P1S	گورويورم
گور+Positive+Continuous+P1P	گورويورز
گور+Positive+Continuous+P3P	گورويور
گور+Positive+Continuous+P3P	گورويورلر
گور+Positive+Continuous+P2P	گورويورسڭز
گور+Positive+Continuous+P2S	گورويورسڭ
گور+Positive+Continuous+P3S	گورويور
گور+Positive+Aorist+P1S	گورورم
گور+Positive+Aorist+P1P	گورورز
گور+Positive+Aorist+P3P	گورور
گور+Positive+Aorist+P3P	گورورلر
گور+Positive+Aorist+P2P	گورورسڭز
گور+Positive+Aorist+P2S	گورورسڭ
گور+Positive+Aorist+P3S	گورور
گيت+Negative+Continuous+P1S	گيتمييورم
گيت+Negative+Continuous+P1P	گيتمييورز
گيت+Negative+Continuous+P3P	گيتمييور
گيت+Negative+Continuous+P3P	گيتمييورلر
گيت+Negative+Continuous+P2P	گيتمييورسڭز
گيت+Negative+Continuous+P2S	گيتمييورسڭ
گيت+Negative+Continuous+P3S	گيتمييور
گيت+Negative+Aorist+P3P	گيتمز
گيت+Negative+Aorist+P3P	گيتمزلر
گيت+Negative+Aorist+P2P	گيتمزسڭز
گيت+Negative+Aorist+P2S	گيتمزسڭ
گيت+Negative+Aorist+P3S	گيتمز
گيت+Negative+Aorist+P1P	گيتميز
گيت+Negative+Aorist+P1S	گيتمم
گيت+Positive+Continuous+P1S	گيتييورم
گيت+Positive+Continuous+P1P	گيتييورز
گيت+Positive+Continuous+P3P	گيتييور
گيت+Positive+Continuous+P3P	گيتييورلر
گيت+Positive+Continuous+P2P	گيتييورسڭز
گيت+Positive+Continuous+P2S	گيتييورسڭ
گيت+Positive+Continuous+P3S	گيتييور
گيت+Positive+Aorist+P1S	گيترم
گيت+Positive+Aorist+P1P	گيترز
گيت+Positive+Aorist+P3P	گيتر
گيت+Positive+Aorist+P3P	گيترلر
گيت+Positive+Aorist+P2P	گيترسڭز
گيت+Positive+Aorist+P2S	گيترسڭ
گيت+Positive+Aorist+P3S	گيتر
